"filename", "language", "TypeScript", "HTML", "SCSS", "comment", "blank", "total"
"d:\AngularProject\Polerace\src\app\Admin\user-management\component\add-user\add-user.component.html", "HTML", 0, 231, 0, 1, 6, 238
"d:\AngularProject\Polerace\src\app\Admin\user-management\component\add-user\add-user.component.scss", "SCSS", 0, 0, 56, 2, 12, 70
"d:\AngularProject\Polerace\src\app\Admin\user-management\component\add-user\add-user.component.spec.ts", "TypeScript", 20, 0, 0, 0, 6, 26
"d:\AngularProject\Polerace\src\app\Admin\user-management\component\add-user\add-user.component.ts", "TypeScript", 196, 0, 0, 41, 28, 265
"d:\AngularProject\Polerace\src\app\Admin\user-management\component\manage-user\manage-user.component.html", "HTML", 0, 116, 0, 3, 6, 125
"d:\AngularProject\Polerace\src\app\Admin\user-management\component\manage-user\manage-user.component.scss", "SCSS", 0, 0, 180, 8, 43, 231
"d:\AngularProject\Polerace\src\app\Admin\user-management\component\manage-user\manage-user.component.spec.ts", "TypeScript", 20, 0, 0, 0, 6, 26
"d:\AngularProject\Polerace\src\app\Admin\user-management\component\manage-user\manage-user.component.ts", "TypeScript", 149, 0, 0, 0, 15, 164
"d:\AngularProject\Polerace\src\app\Admin\user-management\component\subscribed-users\subscribed-users.component.html", "HTML", 0, 152, 0, 2, 7, 161
"d:\AngularProject\Polerace\src\app\Admin\user-management\component\subscribed-users\subscribed-users.component.scss", "SCSS", 0, 0, 180, 8, 43, 231
"d:\AngularProject\Polerace\src\app\Admin\user-management\component\subscribed-users\subscribed-users.component.spec.ts", "TypeScript", 20, 0, 0, 0, 6, 26
"d:\AngularProject\Polerace\src\app\Admin\user-management\component\subscribed-users\subscribed-users.component.ts", "TypeScript", 126, 0, 0, 0, 13, 139
"d:\AngularProject\Polerace\src\app\Admin\user-management\component\update-user-subscription\update-user-subscription.component.html", "HTML", 0, 83, 0, 1, 4, 88
"d:\AngularProject\Polerace\src\app\Admin\user-management\component\update-user-subscription\update-user-subscription.component.scss", "SCSS", 0, 0, 54, 2, 14, 70
"d:\AngularProject\Polerace\src\app\Admin\user-management\component\update-user-subscription\update-user-subscription.component.spec.ts", "TypeScript", 20, 0, 0, 0, 6, 26
"d:\AngularProject\Polerace\src\app\Admin\user-management\component\update-user-subscription\update-user-subscription.component.ts", "TypeScript", 81, 0, 0, 1, 9, 91
"d:\AngularProject\Polerace\src\app\Admin\user-management\user-management-routing.module.ts", "TypeScript", 29, 0, 0, 0, 3, 32
"d:\AngularProject\Polerace\src\app\Admin\user-management\user-management.module.ts", "TypeScript", 29, 0, 0, 0, 2, 31
"d:\AngularProject\Polerace\src\app\Platform\customers\components\add-customer\add-customer.component.html", "HTML", 0, 369, 0, 16, 5, 390
"d:\AngularProject\Polerace\src\app\Platform\customers\components\add-customer\add-customer.component.scss", "SCSS", 0, 0, 57, 2, 15, 74
"d:\AngularProject\Polerace\src\app\Platform\customers\components\add-customer\add-customer.component.ts", "TypeScript", 205, 0, 0, 3, 16, 224
"d:\AngularProject\Polerace\src\app\Platform\customers\components\customer-listing.component.html", "HTML", 0, 170, 0, 6, 10, 186
"d:\AngularProject\Polerace\src\app\Platform\customers\components\customer-listing.component.scss", "SCSS", 0, 0, 20, 2, 0, 22
"d:\AngularProject\Polerace\src\app\Platform\customers\components\customer-listing.component.ts", "TypeScript", 279, 0, 0, 8, 33, 320
"d:\AngularProject\Polerace\src\app\Platform\customers\components\manage-customers\manage-customers.component.html", "HTML", 0, 259, 0, 6, 6, 271
"d:\AngularProject\Polerace\src\app\Platform\customers\components\manage-customers\manage-customers.component.scss", "SCSS", 0, 0, 175, 6, 44, 225
"d:\AngularProject\Polerace\src\app\Platform\customers\components\manage-customers\manage-customers.component.spec.ts", "TypeScript", 20, 0, 0, 0, 6, 26
"d:\AngularProject\Polerace\src\app\Platform\customers\components\manage-customers\manage-customers.component.ts", "TypeScript", 206, 0, 0, 2, 26, 234
"d:\AngularProject\Polerace\src\app\Platform\customers\components\view-customer\view-customer.component.html", "HTML", 0, 75, 0, 2, 20, 97
"d:\AngularProject\Polerace\src\app\Platform\customers\components\view-customer\view-customer.component.scss", "SCSS", 0, 0, 82, 2, 8, 92
"d:\AngularProject\Polerace\src\app\Platform\customers\components\view-customer\view-customer.component.spec.ts", "TypeScript", 20, 0, 0, 0, 6, 26
"d:\AngularProject\Polerace\src\app\Platform\customers\components\view-customer\view-customer.component.ts", "TypeScript", 26, 0, 0, 0, 8, 34
"d:\AngularProject\Polerace\src\app\Platform\customers\customer-routing.module.ts", "TypeScript", 31, 0, 0, 8, 6, 45
"d:\AngularProject\Polerace\src\app\Platform\customers\customer.module.ts", "TypeScript", 116, 0, 0, 0, 1, 117
"d:\AngularProject\Polerace\src\app\Platform\customers\services\customer.service.ts", "TypeScript", 46, 0, 0, 1, 9, 56
"d:\AngularProject\Polerace\src\app\Platform\dashboard\components\dashboard.component.html", "HTML", 0, 231, 0, 39, 14, 284
"d:\AngularProject\Polerace\src\app\Platform\dashboard\components\dashboard.component.scss", "SCSS", 0, 0, 34, 2, 6, 42
"d:\AngularProject\Polerace\src\app\Platform\dashboard\components\dashboard.component.spec.ts", "TypeScript", 20, 0, 0, 0, 7, 27
"d:\AngularProject\Polerace\src\app\Platform\dashboard\components\dashboard.component.ts", "TypeScript", 561, 0, 0, 6, 9, 576
"d:\AngularProject\Polerace\src\app\Platform\dashboard\components\staff-dashboard\staff-dashboard.component.html", "HTML", 0, 183, 0, 15, 13, 211
"d:\AngularProject\Polerace\src\app\Platform\dashboard\components\staff-dashboard\staff-dashboard.component.scss", "SCSS", 0, 0, 46, 2, 8, 56
"d:\AngularProject\Polerace\src\app\Platform\dashboard\components\staff-dashboard\staff-dashboard.component.ts", "TypeScript", 154, 0, 0, 12, 17, 183
"d:\AngularProject\Polerace\src\app\Platform\dashboard\dashboard-routing.module.ts", "TypeScript", 77, 0, 0, 0, 4, 81
"d:\AngularProject\Polerace\src\app\Platform\dashboard\dashboard.module.ts", "TypeScript", 39, 0, 0, 1, 3, 43
"d:\AngularProject\Polerace\src\app\Platform\home\components\about\about.component.html", "HTML", 0, 62, 0, 2, 21, 85
"d:\AngularProject\Polerace\src\app\Platform\home\components\about\about.component.scss", "SCSS", 0, 0, 0, 0, 1, 1
"d:\AngularProject\Polerace\src\app\Platform\home\components\about\about.component.spec.ts", "TypeScript", 20, 0, 0, 0, 6, 26
"d:\AngularProject\Polerace\src\app\Platform\home\components\about\about.component.ts", "TypeScript", 28, 0, 0, 0, 6, 34
"d:\AngularProject\Polerace\src\app\Platform\home\components\advertise\advertise.component.html", "HTML", 0, 29, 0, 3, 17, 49
"d:\AngularProject\Polerace\src\app\Platform\home\components\advertise\advertise.component.scss", "SCSS", 0, 0, 0, 0, 1, 1
"d:\AngularProject\Polerace\src\app\Platform\home\components\advertise\advertise.component.spec.ts", "TypeScript", 20, 0, 0, 0, 6, 26
"d:\AngularProject\Polerace\src\app\Platform\home\components\advertise\advertise.component.ts", "TypeScript", 18, 0, 0, 0, 5, 23
"d:\AngularProject\Polerace\src\app\Platform\home\components\bookmark\bookmark.component.html", "HTML", 0, 29, 0, 3, 17, 49
"d:\AngularProject\Polerace\src\app\Platform\home\components\bookmark\bookmark.component.scss", "SCSS", 0, 0, 0, 0, 1, 1
"d:\AngularProject\Polerace\src\app\Platform\home\components\bookmark\bookmark.component.spec.ts", "TypeScript", 20, 0, 0, 0, 6, 26
"d:\AngularProject\Polerace\src\app\Platform\home\components\bookmark\bookmark.component.ts", "TypeScript", 18, 0, 0, 0, 4, 22
"d:\AngularProject\Polerace\src\app\Platform\home\components\carrer\carrer.component.html", "HTML", 0, 144, 0, 8, 30, 182
"d:\AngularProject\Polerace\src\app\Platform\home\components\carrer\carrer.component.scss", "SCSS", 0, 0, 0, 0, 1, 1
"d:\AngularProject\Polerace\src\app\Platform\home\components\carrer\carrer.component.spec.ts", "TypeScript", 20, 0, 0, 0, 6, 26
"d:\AngularProject\Polerace\src\app\Platform\home\components\carrer\carrer.component.ts", "TypeScript", 18, 0, 0, 0, 4, 22
"d:\AngularProject\Polerace\src\app\Platform\home\components\company-info\company-info.component.html", "HTML", 0, 28, 0, 3, 16, 47
"d:\AngularProject\Polerace\src\app\Platform\home\components\company-info\company-info.component.scss", "SCSS", 0, 0, 0, 0, 1, 1
"d:\AngularProject\Polerace\src\app\Platform\home\components\company-info\company-info.component.spec.ts", "TypeScript", 20, 0, 0, 0, 6, 26
"d:\AngularProject\Polerace\src\app\Platform\home\components\company-info\company-info.component.ts", "TypeScript", 18, 0, 0, 0, 4, 22
"d:\AngularProject\Polerace\src\app\Platform\home\components\contact\contact.component.html", "HTML", 0, 80, 0, 3, 23, 106
"d:\AngularProject\Polerace\src\app\Platform\home\components\contact\contact.component.scss", "SCSS", 0, 0, 0, 0, 1, 1
"d:\AngularProject\Polerace\src\app\Platform\home\components\contact\contact.component.spec.ts", "TypeScript", 20, 0, 0, 0, 6, 26
"d:\AngularProject\Polerace\src\app\Platform\home\components\contact\contact.component.ts", "TypeScript", 18, 0, 0, 0, 4, 22
"d:\AngularProject\Polerace\src\app\Platform\home\components\copy-right\copy-right.component.html", "HTML", 0, 29, 0, 3, 17, 49
"d:\AngularProject\Polerace\src\app\Platform\home\components\copy-right\copy-right.component.scss", "SCSS", 0, 0, 0, 0, 1, 1
"d:\AngularProject\Polerace\src\app\Platform\home\components\copy-right\copy-right.component.spec.ts", "TypeScript", 20, 0, 0, 0, 6, 26
"d:\AngularProject\Polerace\src\app\Platform\home\components\copy-right\copy-right.component.ts", "TypeScript", 18, 0, 0, 0, 6, 24
"d:\AngularProject\Polerace\src\app\Platform\home\components\demo\demo.component.html", "HTML", 0, 51, 0, 5, 7, 63
"d:\AngularProject\Polerace\src\app\Platform\home\components\demo\demo.component.scss", "SCSS", 0, 0, 0, 0, 1, 1
"d:\AngularProject\Polerace\src\app\Platform\home\components\demo\demo.component.spec.ts", "TypeScript", 20, 0, 0, 0, 6, 26
"d:\AngularProject\Polerace\src\app\Platform\home\components\demo\demo.component.ts", "TypeScript", 29, 0, 0, 0, 6, 35
"d:\AngularProject\Polerace\src\app\Platform\home\components\email\email.component.html", "HTML", 0, 29, 0, 3, 17, 49
"d:\AngularProject\Polerace\src\app\Platform\home\components\email\email.component.scss", "SCSS", 0, 0, 0, 0, 1, 1
"d:\AngularProject\Polerace\src\app\Platform\home\components\email\email.component.spec.ts", "TypeScript", 20, 0, 0, 0, 6, 26
"d:\AngularProject\Polerace\src\app\Platform\home\components\email\email.component.ts", "TypeScript", 18, 0, 0, 0, 5, 23
"d:\AngularProject\Polerace\src\app\Platform\home\components\faq-cat\faq-cat.component.html", "HTML", 0, 78, 0, 2, 23, 103
"d:\AngularProject\Polerace\src\app\Platform\home\components\faq-cat\faq-cat.component.scss", "SCSS", 0, 0, 0, 0, 1, 1
"d:\AngularProject\Polerace\src\app\Platform\home\components\faq-cat\faq-cat.component.spec.ts", "TypeScript", 20, 0, 0, 0, 6, 26
"d:\AngularProject\Polerace\src\app\Platform\home\components\faq-cat\faq-cat.component.ts", "TypeScript", 18, 0, 0, 0, 5, 23
"d:\AngularProject\Polerace\src\app\Platform\home\components\faq-details\faq-details.component.html", "HTML", 0, 70, 0, 3, 19, 92
"d:\AngularProject\Polerace\src\app\Platform\home\components\faq-details\faq-details.component.scss", "SCSS", 0, 0, 0, 0, 1, 1
"d:\AngularProject\Polerace\src\app\Platform\home\components\faq-details\faq-details.component.spec.ts", "TypeScript", 20, 0, 0, 0, 6, 26
"d:\AngularProject\Polerace\src\app\Platform\home\components\faq-details\faq-details.component.ts", "TypeScript", 18, 0, 0, 0, 5, 23
"d:\AngularProject\Polerace\src\app\Platform\home\components\help\help.component.html", "HTML", 0, 69, 0, 3, 20, 92
"d:\AngularProject\Polerace\src\app\Platform\home\components\help\help.component.scss", "SCSS", 0, 0, 0, 0, 1, 1
"d:\AngularProject\Polerace\src\app\Platform\home\components\help\help.component.spec.ts", "TypeScript", 20, 0, 0, 0, 6, 26
"d:\AngularProject\Polerace\src\app\Platform\home\components\help\help.component.ts", "TypeScript", 18, 0, 0, 0, 5, 23
"d:\AngularProject\Polerace\src\app\Platform\home\components\home\home.component.html", "HTML", 0, 1141, 0, 0, 15, 1156
"d:\AngularProject\Polerace\src\app\Platform\home\components\home\home.component.scss", "SCSS", 0, 0, 44, 0, 3, 47
"d:\AngularProject\Polerace\src\app\Platform\home\components\home\home.component.spec.ts", "TypeScript", 20, 0, 0, 0, 6, 26
"d:\AngularProject\Polerace\src\app\Platform\home\components\home\home.component.ts", "TypeScript", 26, 0, 0, 0, 9, 35
"d:\AngularProject\Polerace\src\app\Platform\home\components\homefooter\homefooter.component.html", "HTML", 0, 72, 0, 7, 1, 80
"d:\AngularProject\Polerace\src\app\Platform\home\components\homefooter\homefooter.component.scss", "SCSS", 0, 0, 0, 0, 1, 1
"d:\AngularProject\Polerace\src\app\Platform\home\components\homefooter\homefooter.component.spec.ts", "TypeScript", 20, 0, 0, 0, 6, 26
"d:\AngularProject\Polerace\src\app\Platform\home\components\homefooter\homefooter.component.ts", "TypeScript", 11, 0, 0, 0, 5, 16
"d:\AngularProject\Polerace\src\app\Platform\home\components\homeheader\homeheader.component.html", "HTML", 0, 40, 0, 5, 2, 47
"d:\AngularProject\Polerace\src\app\Platform\home\components\homeheader\homeheader.component.scss", "SCSS", 0, 0, 7, 4, 3, 14
"d:\AngularProject\Polerace\src\app\Platform\home\components\homeheader\homeheader.component.spec.ts", "TypeScript", 20, 0, 0, 0, 6, 26
"d:\AngularProject\Polerace\src\app\Platform\home\components\homeheader\homeheader.component.ts", "TypeScript", 11, 0, 0, 0, 5, 16
"d:\AngularProject\Polerace\src\app\Platform\home\components\imigration\imigration.component.html", "HTML", 0, 0, 0, 0, 1, 1
"d:\AngularProject\Polerace\src\app\Platform\home\components\imigration\imigration.component.scss", "SCSS", 0, 0, 0, 0, 1, 1
"d:\AngularProject\Polerace\src\app\Platform\home\components\imigration\imigration.component.spec.ts", "TypeScript", 20, 0, 0, 0, 6, 26
"d:\AngularProject\Polerace\src\app\Platform\home\components\imigration\imigration.component.ts", "TypeScript", 11, 0, 0, 0, 5, 16
"d:\AngularProject\Polerace\src\app\Platform\home\components\imigrationandpartners\imigrationandpartners.component.html", "HTML", 0, 400, 0, 5, 17, 422
"d:\AngularProject\Polerace\src\app\Platform\home\components\imigrationandpartners\imigrationandpartners.component.scss", "SCSS", 0, 0, 0, 0, 1, 1
"d:\AngularProject\Polerace\src\app\Platform\home\components\imigrationandpartners\imigrationandpartners.component.spec.ts", "TypeScript", 20, 0, 0, 0, 6, 26
"d:\AngularProject\Polerace\src\app\Platform\home\components\imigrationandpartners\imigrationandpartners.component.ts", "TypeScript", 29, 0, 0, 0, 7, 36
"d:\AngularProject\Polerace\src\app\Platform\home\components\prcing\prcing.component.html", "HTML", 0, 69, 0, 3, 25, 97
"d:\AngularProject\Polerace\src\app\Platform\home\components\prcing\prcing.component.scss", "SCSS", 0, 0, 0, 0, 1, 1
"d:\AngularProject\Polerace\src\app\Platform\home\components\prcing\prcing.component.spec.ts", "TypeScript", 20, 0, 0, 0, 6, 26
"d:\AngularProject\Polerace\src\app\Platform\home\components\prcing\prcing.component.ts", "TypeScript", 29, 0, 0, 0, 7, 36
"d:\AngularProject\Polerace\src\app\Platform\home\components\privacy\privacy.component.html", "HTML", 0, 27, 0, 3, 17, 47
"d:\AngularProject\Polerace\src\app\Platform\home\components\privacy\privacy.component.scss", "SCSS", 0, 0, 0, 0, 1, 1
"d:\AngularProject\Polerace\src\app\Platform\home\components\privacy\privacy.component.spec.ts", "TypeScript", 20, 0, 0, 0, 6, 26
"d:\AngularProject\Polerace\src\app\Platform\home\components\privacy\privacy.component.ts", "TypeScript", 29, 0, 0, 0, 7, 36
"d:\AngularProject\Polerace\src\app\Platform\home\components\product\product.component.html", "HTML", 0, 99, 0, 16, 19, 134
"d:\AngularProject\Polerace\src\app\Platform\home\components\product\product.component.scss", "SCSS", 0, 0, 0, 0, 1, 1
"d:\AngularProject\Polerace\src\app\Platform\home\components\product\product.component.spec.ts", "TypeScript", 20, 0, 0, 0, 6, 26
"d:\AngularProject\Polerace\src\app\Platform\home\components\product\product.component.ts", "TypeScript", 29, 0, 0, 0, 7, 36
"d:\AngularProject\Polerace\src\app\Platform\home\components\productandfeatures\productandfeatures.component.html", "HTML", 0, 92, 0, 3, 40, 135
"d:\AngularProject\Polerace\src\app\Platform\home\components\productandfeatures\productandfeatures.component.scss", "SCSS", 0, 0, 0, 0, 1, 1
"d:\AngularProject\Polerace\src\app\Platform\home\components\productandfeatures\productandfeatures.component.spec.ts", "TypeScript", 20, 0, 0, 0, 6, 26
"d:\AngularProject\Polerace\src\app\Platform\home\components\productandfeatures\productandfeatures.component.ts", "TypeScript", 29, 0, 0, 0, 6, 35
"d:\AngularProject\Polerace\src\app\Platform\home\components\resources\resources.component.html", "HTML", 0, 29, 0, 3, 17, 49
"d:\AngularProject\Polerace\src\app\Platform\home\components\resources\resources.component.scss", "SCSS", 0, 0, 0, 0, 1, 1
"d:\AngularProject\Polerace\src\app\Platform\home\components\resources\resources.component.spec.ts", "TypeScript", 20, 0, 0, 0, 6, 26
"d:\AngularProject\Polerace\src\app\Platform\home\components\resources\resources.component.ts", "TypeScript", 29, 0, 0, 0, 5, 34
"d:\AngularProject\Polerace\src\app\Platform\home\components\sitemap\sitemap.component.html", "HTML", 0, 157, 0, 3, 25, 185
"d:\AngularProject\Polerace\src\app\Platform\home\components\sitemap\sitemap.component.scss", "SCSS", 0, 0, 3, 0, 1, 4
"d:\AngularProject\Polerace\src\app\Platform\home\components\sitemap\sitemap.component.spec.ts", "TypeScript", 20, 0, 0, 0, 6, 26
"d:\AngularProject\Polerace\src\app\Platform\home\components\sitemap\sitemap.component.ts", "TypeScript", 18, 0, 0, 0, 3, 21
"d:\AngularProject\Polerace\src\app\Platform\home\components\solutions\solutions.component.html", "HTML", 0, 29, 0, 3, 17, 49
"d:\AngularProject\Polerace\src\app\Platform\home\components\solutions\solutions.component.scss", "SCSS", 0, 0, 0, 0, 1, 1
"d:\AngularProject\Polerace\src\app\Platform\home\components\solutions\solutions.component.spec.ts", "TypeScript", 20, 0, 0, 0, 6, 26
"d:\AngularProject\Polerace\src\app\Platform\home\components\solutions\solutions.component.ts", "TypeScript", 18, 0, 0, 0, 4, 22
"d:\AngularProject\Polerace\src\app\Platform\home\components\subscription\subscription.component.html", "HTML", 0, 67, 0, 3, 15, 85
"d:\AngularProject\Polerace\src\app\Platform\home\components\subscription\subscription.component.scss", "SCSS", 0, 0, 17, 0, 2, 19
"d:\AngularProject\Polerace\src\app\Platform\home\components\subscription\subscription.component.spec.ts", "TypeScript", 20, 0, 0, 0, 6, 26
"d:\AngularProject\Polerace\src\app\Platform\home\components\subscription\subscription.component.ts", "TypeScript", 18, 0, 0, 0, 3, 21
"d:\AngularProject\Polerace\src\app\Platform\home\components\terms\terms.component.html", "HTML", 0, 27, 0, 3, 17, 47
"d:\AngularProject\Polerace\src\app\Platform\home\components\terms\terms.component.scss", "SCSS", 0, 0, 0, 0, 1, 1
"d:\AngularProject\Polerace\src\app\Platform\home\components\terms\terms.component.spec.ts", "TypeScript", 20, 0, 0, 0, 6, 26
"d:\AngularProject\Polerace\src\app\Platform\home\components\terms\terms.component.ts", "TypeScript", 18, 0, 0, 0, 3, 21
"d:\AngularProject\Polerace\src\app\Platform\home\components\topics\topics.component.html", "HTML", 0, 29, 0, 3, 14, 46
"d:\AngularProject\Polerace\src\app\Platform\home\components\topics\topics.component.scss", "SCSS", 0, 0, 0, 0, 1, 1
"d:\AngularProject\Polerace\src\app\Platform\home\components\topics\topics.component.spec.ts", "TypeScript", 20, 0, 0, 0, 6, 26
"d:\AngularProject\Polerace\src\app\Platform\home\components\topics\topics.component.ts", "TypeScript", 18, 0, 0, 0, 3, 21
"d:\AngularProject\Polerace\src\app\Platform\home\home-routing.module.ts", "TypeScript", 112, 0, 0, 0, 6, 118
"d:\AngularProject\Polerace\src\app\Platform\home\home.module.ts", "TypeScript", 38, 0, 0, 0, 4, 42
"d:\AngularProject\Polerace\src\app\Platform\inventory\components\Brands\add-brand.component.html", "HTML", 0, 58, 0, 0, 2, 60
"d:\AngularProject\Polerace\src\app\Platform\inventory\components\Brands\add-brand.component.scss", "SCSS", 0, 0, 17, 0, 1, 18
"d:\AngularProject\Polerace\src\app\Platform\inventory\components\Brands\add-brand.component.ts", "TypeScript", 85, 0, 0, 2, 20, 107
"d:\AngularProject\Polerace\src\app\Platform\inventory\components\add-category\add-category.component.html", "HTML", 0, 84, 0, 5, 3, 92
"d:\AngularProject\Polerace\src\app\Platform\inventory\components\add-category\add-category.component.scss", "SCSS", 0, 0, 66, 2, 19, 87
"d:\AngularProject\Polerace\src\app\Platform\inventory\components\add-category\add-category.component.ts", "TypeScript", 148, 0, 0, 4, 25, 177
"d:\AngularProject\Polerace\src\app\Platform\inventory\components\add-product-via-excel\add-product-via-excel.component.html", "HTML", 0, 111, 0, 3, 6, 120
"d:\AngularProject\Polerace\src\app\Platform\inventory\components\add-product-via-excel\add-product-via-excel.component.scss", "SCSS", 0, 0, 17, 0, 1, 18
"d:\AngularProject\Polerace\src\app\Platform\inventory\components\add-product-via-excel\add-product-via-excel.component.ts", "TypeScript", 83, 0, 0, 0, 12, 95
"d:\AngularProject\Polerace\src\app\Platform\inventory\components\add-product\add-product.component.html", "HTML", 0, 1920, 0, 245, 73, 2238
"d:\AngularProject\Polerace\src\app\Platform\inventory\components\add-product\add-product.component.scss", "SCSS", 0, 0, 165, 4, 33, 202
"d:\AngularProject\Polerace\src\app\Platform\inventory\components\add-product\add-product.component.spec.ts", "TypeScript", 20, 0, 0, 0, 6, 26
"d:\AngularProject\Polerace\src\app\Platform\inventory\components\add-product\add-product.component.ts", "TypeScript", 560, 0, 0, 13, 41, 614
"d:\AngularProject\Polerace\src\app\Platform\inventory\components\add-subcategory\add-subcategory.component.html", "HTML", 0, 141, 0, 5, 9, 155
"d:\AngularProject\Polerace\src\app\Platform\inventory\components\add-subcategory\add-subcategory.component.scss", "SCSS", 0, 0, 62, 2, 16, 80
"d:\AngularProject\Polerace\src\app\Platform\inventory\components\add-subcategory\add-subcategory.component.spec.ts", "TypeScript", 20, 0, 0, 0, 6, 26
"d:\AngularProject\Polerace\src\app\Platform\inventory\components\add-subcategory\add-subcategory.component.ts", "TypeScript", 174, 0, 0, 3, 15, 192
"d:\AngularProject\Polerace\src\app\Platform\inventory\components\brands-listing\brands-listing.component.html", "HTML", 0, 58, 0, 13, 15, 86
"d:\AngularProject\Polerace\src\app\Platform\inventory\components\brands-listing\brands-listing.component.scss", "SCSS", 0, 0, 13, 0, 2, 15
"d:\AngularProject\Polerace\src\app\Platform\inventory\components\brands-listing\brands-listing.component.ts", "TypeScript", 116, 0, 0, 3, 10, 129
"d:\AngularProject\Polerace\src\app\Platform\inventory\components\category-listing\category-listing.component.html", "HTML", 0, 84, 0, 0, 15, 99
"d:\AngularProject\Polerace\src\app\Platform\inventory\components\category-listing\category-listing.component.scss", "SCSS", 0, 0, 0, 0, 1, 1
"d:\AngularProject\Polerace\src\app\Platform\inventory\components\category-listing\category-listing.component.ts", "TypeScript", 86, 0, 0, 3, 17, 106
"d:\AngularProject\Polerace\src\app\Platform\inventory\components\categorylisting\categorylisting.component.html", "HTML", 0, 169, 0, 7, 6, 182
"d:\AngularProject\Polerace\src\app\Platform\inventory\components\categorylisting\categorylisting.component.scss", "SCSS", 0, 0, 160, 6, 38, 204
"d:\AngularProject\Polerace\src\app\Platform\inventory\components\categorylisting\categorylisting.component.spec.ts", "TypeScript", 20, 0, 0, 0, 6, 26
"d:\AngularProject\Polerace\src\app\Platform\inventory\components\categorylisting\categorylisting.component.ts", "TypeScript", 194, 0, 0, 1, 15, 210
"d:\AngularProject\Polerace\src\app\Platform\inventory\components\custom-attribute\custom-attribute.component.html", "HTML", 0, 56, 0, 12, 0, 68
"d:\AngularProject\Polerace\src\app\Platform\inventory\components\custom-attribute\custom-attribute.component.scss", "SCSS", 0, 0, 35, 2, 4, 41
"d:\AngularProject\Polerace\src\app\Platform\inventory\components\custom-attribute\custom-attribute.component.ts", "TypeScript", 82, 0, 0, 1, 13, 96
"d:\AngularProject\Polerace\src\app\Platform\inventory\components\import-category-via-excel\import-category-via-excel.component.html", "HTML", 0, 111, 0, 3, 5, 119
"d:\AngularProject\Polerace\src\app\Platform\inventory\components\import-category-via-excel\import-category-via-excel.component.scss", "SCSS", 0, 0, 17, 0, 1, 18
"d:\AngularProject\Polerace\src\app\Platform\inventory\components\import-category-via-excel\import-category-via-excel.component.ts", "TypeScript", 83, 0, 0, 0, 11, 94
"d:\AngularProject\Polerace\src\app\Platform\inventory\components\inventory-listing\inventory-listing.component.html", "HTML", 0, 106, 0, 6, 5, 117
"d:\AngularProject\Polerace\src\app\Platform\inventory\components\inventory-listing\inventory-listing.component.scss", "SCSS", 0, 0, 429, 17, 101, 547
"d:\AngularProject\Polerace\src\app\Platform\inventory\components\inventory-listing\inventory-listing.component.spec.ts", "TypeScript", 20, 0, 0, 0, 6, 26
"d:\AngularProject\Polerace\src\app\Platform\inventory\components\inventory-listing\inventory-listing.component.ts", "TypeScript", 170, 0, 0, 0, 14, 184
"d:\AngularProject\Polerace\src\app\Platform\inventory\components\manage-product\manage-product.component.html", "HTML", 0, 143, 0, 13, 8, 164
"d:\AngularProject\Polerace\src\app\Platform\inventory\components\manage-product\manage-product.component.scss", "SCSS", 0, 0, 129, 2, 26, 157
"d:\AngularProject\Polerace\src\app\Platform\inventory\components\manage-product\manage-product.component.spec.ts", "TypeScript", 20, 0, 0, 0, 6, 26
"d:\AngularProject\Polerace\src\app\Platform\inventory\components\manage-product\manage-product.component.ts", "TypeScript", 258, 0, 0, 16, 29, 303
"d:\AngularProject\Polerace\src\app\Platform\inventory\components\product-insights\product-insights.component.html", "HTML", 0, 200, 0, 37, 30, 267
"d:\AngularProject\Polerace\src\app\Platform\inventory\components\product-insights\product-insights.component.scss", "SCSS", 0, 0, 89, 5, 16, 110
"d:\AngularProject\Polerace\src\app\Platform\inventory\components\product-insights\product-insights.component.spec.ts", "TypeScript", 20, 0, 0, 0, 6, 26
"d:\AngularProject\Polerace\src\app\Platform\inventory\components\product-insights\product-insights.component.ts", "TypeScript", 813, 0, 0, 4, 36, 853
"d:\AngularProject\Polerace\src\app\Platform\inventory\components\product\product.component.html", "HTML", 0, 489, 0, 148, 69, 706
"d:\AngularProject\Polerace\src\app\Platform\inventory\components\product\product.component.scss", "SCSS", 0, 0, 26, 1, 2, 29
"d:\AngularProject\Polerace\src\app\Platform\inventory\components\product\product.component.ts", "TypeScript", 714, 0, 0, 20, 49, 783
"d:\AngularProject\Polerace\src\app\Platform\inventory\components\productorderlistbysupplier\productorderlistbysupplier.component.html", "HTML", 0, 160, 0, 5, 6, 171
"d:\AngularProject\Polerace\src\app\Platform\inventory\components\productorderlistbysupplier\productorderlistbysupplier.component.scss", "SCSS", 0, 0, 109, 2, 21, 132
"d:\AngularProject\Polerace\src\app\Platform\inventory\components\productorderlistbysupplier\productorderlistbysupplier.component.spec.ts", "TypeScript", 20, 0, 0, 0, 6, 26
"d:\AngularProject\Polerace\src\app\Platform\inventory\components\productorderlistbysupplier\productorderlistbysupplier.component.ts", "TypeScript", 156, 0, 0, 1, 15, 172
"d:\AngularProject\Polerace\src\app\Platform\inventory\components\subcategory-listing\subcategory-listing.component.html", "HTML", 0, 171, 0, 11, 6, 188
"d:\AngularProject\Polerace\src\app\Platform\inventory\components\subcategory-listing\subcategory-listing.component.scss", "SCSS", 0, 0, 160, 6, 39, 205
"d:\AngularProject\Polerace\src\app\Platform\inventory\components\subcategory-listing\subcategory-listing.component.spec.ts", "TypeScript", 20, 0, 0, 0, 6, 26
"d:\AngularProject\Polerace\src\app\Platform\inventory\components\subcategory-listing\subcategory-listing.component.ts", "TypeScript", 166, 0, 0, 1, 15, 182
"d:\AngularProject\Polerace\src\app\Platform\inventory\components\supplierpurchaseorderhistory\supplierpurchaseorderhistory.component.html", "HTML", 0, 164, 0, 18, 7, 189
"d:\AngularProject\Polerace\src\app\Platform\inventory\components\supplierpurchaseorderhistory\supplierpurchaseorderhistory.component.scss", "SCSS", 0, 0, 109, 2, 21, 132
"d:\AngularProject\Polerace\src\app\Platform\inventory\components\supplierpurchaseorderhistory\supplierpurchaseorderhistory.component.spec.ts", "TypeScript", 20, 0, 0, 0, 6, 26
"d:\AngularProject\Polerace\src\app\Platform\inventory\components\supplierpurchaseorderhistory\supplierpurchaseorderhistory.component.ts", "TypeScript", 71, 0, 0, 2, 5, 78
"d:\AngularProject\Polerace\src\app\Platform\inventory\components\suppliers-listing\suppliers-listing.component.html", "HTML", 0, 112, 0, 8, 5, 125
"d:\AngularProject\Polerace\src\app\Platform\inventory\components\suppliers-listing\suppliers-listing.component.scss", "SCSS", 0, 0, 153, 6, 38, 197
"d:\AngularProject\Polerace\src\app\Platform\inventory\components\suppliers-listing\suppliers-listing.component.ts", "TypeScript", 207, 0, 0, 5, 19, 231
"d:\AngularProject\Polerace\src\app\Platform\inventory\components\suppliers\add-suppliers.component.html", "HTML", 0, 224, 0, 0, 5, 229
"d:\AngularProject\Polerace\src\app\Platform\inventory\components\suppliers\add-suppliers.component.scss", "SCSS", 0, 0, 54, 2, 14, 70
"d:\AngularProject\Polerace\src\app\Platform\inventory\components\suppliers\add-suppliers.component.ts", "TypeScript", 153, 0, 0, 16, 23, 192
"d:\AngularProject\Polerace\src\app\Platform\inventory\components\update-inventory\update-inventory.component.html", "HTML", 0, 732, 0, 93, 32, 857
"d:\AngularProject\Polerace\src\app\Platform\inventory\components\update-inventory\update-inventory.component.scss", "SCSS", 0, 0, 45, 43, 15, 103
"d:\AngularProject\Polerace\src\app\Platform\inventory\components\update-inventory\update-inventory.component.spec.ts", "TypeScript", 20, 0, 0, 0, 6, 26
"d:\AngularProject\Polerace\src\app\Platform\inventory\components\update-inventory\update-inventory.component.ts", "TypeScript", 264, 0, 0, 0, 16, 280
"d:\AngularProject\Polerace\src\app\Platform\inventory\components\view-product\view-product.component.html", "HTML", 0, 137, 0, 27, 11, 175
"d:\AngularProject\Polerace\src\app\Platform\inventory\components\view-product\view-product.component.scss", "SCSS", 0, 0, 74, 1, 4, 79
"d:\AngularProject\Polerace\src\app\Platform\inventory\components\view-product\view-product.component.spec.ts", "TypeScript", 20, 0, 0, 0, 6, 26
"d:\AngularProject\Polerace\src\app\Platform\inventory\components\view-product\view-product.component.ts", "TypeScript", 51, 0, 0, 0, 4, 55
"d:\AngularProject\Polerace\src\app\Platform\inventory\inventory-routing.module.ts", "TypeScript", 108, 0, 0, 4, 6, 118
"d:\AngularProject\Polerace\src\app\Platform\inventory\inventory.module.ts", "TypeScript", 155, 0, 0, 2, 2, 159
"d:\AngularProject\Polerace\src\app\Platform\inventory\models\product-images.ts", "TypeScript", 10, 0, 0, 0, 0, 10
"d:\AngularProject\Polerace\src\app\Platform\inventory\services\inventory.service.ts", "TypeScript", 211, 0, 0, 33, 56, 300
"d:\AngularProject\Polerace\src\app\Platform\marketplaces\components\add-marketplaces\add-marketplaces.component.html", "HTML", 0, 178, 0, 0, 14, 192
"d:\AngularProject\Polerace\src\app\Platform\marketplaces\components\add-marketplaces\add-marketplaces.component.scss", "SCSS", 0, 0, 29, 0, 6, 35
"d:\AngularProject\Polerace\src\app\Platform\marketplaces\components\add-marketplaces\add-marketplaces.component.spec.ts", "TypeScript", 20, 0, 0, 0, 6, 26
"d:\AngularProject\Polerace\src\app\Platform\marketplaces\components\add-marketplaces\add-marketplaces.component.ts", "TypeScript", 206, 0, 0, 2, 12, 220
"d:\AngularProject\Polerace\src\app\Platform\marketplaces\components\add-sales-taxes-dialog\add-sales-taxes-dialog.component.html", "HTML", 0, 41, 0, 0, 5, 46
"d:\AngularProject\Polerace\src\app\Platform\marketplaces\components\add-sales-taxes-dialog\add-sales-taxes-dialog.component.scss", "SCSS", 0, 0, 15, 0, 6, 21
"d:\AngularProject\Polerace\src\app\Platform\marketplaces\components\add-sales-taxes-dialog\add-sales-taxes-dialog.component.ts", "TypeScript", 57, 0, 0, 2, 10, 69
"d:\AngularProject\Polerace\src\app\Platform\marketplaces\components\amazon-configuration-dialog\amazon-configuration-dialog.component.html", "HTML", 0, 187, 0, 5, 5, 197
"d:\AngularProject\Polerace\src\app\Platform\marketplaces\components\amazon-configuration-dialog\amazon-configuration-dialog.component.scss", "SCSS", 0, 0, 74, 0, 15, 89
"d:\AngularProject\Polerace\src\app\Platform\marketplaces\components\amazon-configuration-dialog\amazon-configuration-dialog.component.ts", "TypeScript", 184, 0, 0, 3, 22, 209
"d:\AngularProject\Polerace\src\app\Platform\marketplaces\components\channel-configurations\channel-configurations.component.html", "HTML", 0, 27, 0, 0, 5, 32
"d:\AngularProject\Polerace\src\app\Platform\marketplaces\components\channel-configurations\channel-configurations.component.scss", "SCSS", 0, 0, 32, 1, 7, 40
"d:\AngularProject\Polerace\src\app\Platform\marketplaces\components\channel-configurations\channel-configurations.component.ts", "TypeScript", 126, 0, 0, 3, 19, 148
"d:\AngularProject\Polerace\src\app\Platform\marketplaces\components\e-bay-configuration-dialog\e-bay-configuration-dialog.component.html", "HTML", 0, 116, 0, 4, 7, 127
"d:\AngularProject\Polerace\src\app\Platform\marketplaces\components\e-bay-configuration-dialog\e-bay-configuration-dialog.component.scss", "SCSS", 0, 0, 80, 0, 18, 98
"d:\AngularProject\Polerace\src\app\Platform\marketplaces\components\e-bay-configuration-dialog\e-bay-configuration-dialog.component.ts", "TypeScript", 76, 0, 0, 2, 13, 91
"d:\AngularProject\Polerace\src\app\Platform\marketplaces\components\manage-sales-channels\manage-sales-channels.component.html", "HTML", 0, 170, 0, 7, 7, 184
"d:\AngularProject\Polerace\src\app\Platform\marketplaces\components\manage-sales-channels\manage-sales-channels.component.scss", "SCSS", 0, 0, 177, 8, 42, 227
"d:\AngularProject\Polerace\src\app\Platform\marketplaces\components\manage-sales-channels\manage-sales-channels.component.ts", "TypeScript", 203, 0, 0, 6, 22, 231
"d:\AngularProject\Polerace\src\app\Platform\marketplaces\components\marketplace-listing\marketplace-listing.component.html", "HTML", 0, 170, 0, 8, 7, 185
"d:\AngularProject\Polerace\src\app\Platform\marketplaces\components\marketplace-listing\marketplace-listing.component.scss", "SCSS", 0, 0, 140, 3, 36, 179
"d:\AngularProject\Polerace\src\app\Platform\marketplaces\components\marketplace-listing\marketplace-listing.component.spec.ts", "TypeScript", 20, 0, 0, 0, 6, 26
"d:\AngularProject\Polerace\src\app\Platform\marketplaces\components\marketplace-listing\marketplace-listing.component.ts", "TypeScript", 54, 0, 0, 0, 9, 63
"d:\AngularProject\Polerace\src\app\Platform\marketplaces\components\marketplaces-fields-mapping\marketplaces-fields-mapping.component.html", "HTML", 0, 166, 0, 27, 8, 201
"d:\AngularProject\Polerace\src\app\Platform\marketplaces\components\marketplaces-fields-mapping\marketplaces-fields-mapping.component.scss", "SCSS", 0, 0, 26, 0, 1, 27
"d:\AngularProject\Polerace\src\app\Platform\marketplaces\components\marketplaces-fields-mapping\marketplaces-fields-mapping.component.ts", "TypeScript", 176, 0, 0, 4, 24, 204
"d:\AngularProject\Polerace\src\app\Platform\marketplaces\components\orders-from-diff-marketplaces\orders-from-diff-marketplaces.component.html", "HTML", 0, 130, 0, 7, 5, 142
"d:\AngularProject\Polerace\src\app\Platform\marketplaces\components\orders-from-diff-marketplaces\orders-from-diff-marketplaces.component.scss", "SCSS", 0, 0, 247, 6, 65, 318
"d:\AngularProject\Polerace\src\app\Platform\marketplaces\components\orders-from-diff-marketplaces\orders-from-diff-marketplaces.component.spec.ts", "TypeScript", 20, 0, 0, 0, 6, 26
"d:\AngularProject\Polerace\src\app\Platform\marketplaces\components\orders-from-diff-marketplaces\orders-from-diff-marketplaces.component.ts", "TypeScript", 417, 0, 0, 4, 29, 450
"d:\AngularProject\Polerace\src\app\Platform\marketplaces\components\view-orderdetails-from-diff-channels\view-orderdetails-from-diff-channels.component.html", "HTML", 0, 81, 0, 2, 4, 87
"d:\AngularProject\Polerace\src\app\Platform\marketplaces\components\view-orderdetails-from-diff-channels\view-orderdetails-from-diff-channels.component.scss", "SCSS", 0, 0, 44, 2, 9, 55
"d:\AngularProject\Polerace\src\app\Platform\marketplaces\components\view-orderdetails-from-diff-channels\view-orderdetails-from-diff-channels.component.spec.ts", "TypeScript", 20, 0, 0, 0, 6, 26
"d:\AngularProject\Polerace\src\app\Platform\marketplaces\components\view-orderdetails-from-diff-channels\view-orderdetails-from-diff-channels.component.ts", "TypeScript", 42, 0, 0, 0, 8, 50
"d:\AngularProject\Polerace\src\app\Platform\marketplaces\components\walmart-configuration-dialog\walmart-configuration-dialog.component.html", "HTML", 0, 96, 0, 0, 10, 106
"d:\AngularProject\Polerace\src\app\Platform\marketplaces\components\walmart-configuration-dialog\walmart-configuration-dialog.component.scss", "SCSS", 0, 0, 68, 0, 14, 82
"d:\AngularProject\Polerace\src\app\Platform\marketplaces\components\walmart-configuration-dialog\walmart-configuration-dialog.component.ts", "TypeScript", 89, 0, 0, 7, 13, 109
"d:\AngularProject\Polerace\src\app\Platform\marketplaces\marketplaces-routing.module.ts", "TypeScript", 41, 0, 0, 8, 4, 53
"d:\AngularProject\Polerace\src\app\Platform\marketplaces\marketplaces.module.ts", "TypeScript", 132, 0, 0, 0, 2, 134
"d:\AngularProject\Polerace\src\app\Platform\marketplaces\models\eBayAuthorizeCode.ts", "TypeScript", 3, 0, 0, 0, 0, 3
"d:\AngularProject\Polerace\src\app\Platform\marketplaces\services\marketplaces.service.ts", "TypeScript", 135, 0, 0, 26, 37, 198
"d:\AngularProject\Polerace\src\app\Platform\orders\add-order\add-order.component.html", "HTML", 0, 197, 0, 6, 21, 224
"d:\AngularProject\Polerace\src\app\Platform\orders\add-order\add-order.component.scss", "SCSS", 0, 0, 54, 2, 13, 69
"d:\AngularProject\Polerace\src\app\Platform\orders\add-order\add-order.component.spec.ts", "TypeScript", 20, 0, 0, 0, 6, 26
"d:\AngularProject\Polerace\src\app\Platform\orders\add-order\add-order.component.ts", "TypeScript", 352, 0, 0, 3, 41, 396
"d:\AngularProject\Polerace\src\app\Platform\orders\order-listing\order-listing.component.html", "HTML", 0, 113, 0, 9, 6, 128
"d:\AngularProject\Polerace\src\app\Platform\orders\order-listing\order-listing.component.scss", "SCSS", 0, 0, 272, 8, 62, 342
"d:\AngularProject\Polerace\src\app\Platform\orders\order-listing\order-listing.component.spec.ts", "TypeScript", 20, 0, 0, 0, 6, 26
"d:\AngularProject\Polerace\src\app\Platform\orders\order-listing\order-listing.component.ts", "TypeScript", 219, 0, 0, 1, 17, 237
"d:\AngularProject\Polerace\src\app\Platform\orders\orders.module.ts", "TypeScript", 118, 0, 0, 0, 3, 121
"d:\AngularProject\Polerace\src\app\Platform\orders\orders.routing.ts", "TypeScript", 31, 0, 0, 0, 2, 33
"d:\AngularProject\Polerace\src\app\Platform\orders\services\amazon.orders.services.ts", "TypeScript", 33, 0, 0, 0, 9, 42
"d:\AngularProject\Polerace\src\app\Platform\orders\services\ebay.orders.service.ts", "TypeScript", 17, 0, 0, 0, 7, 24
"d:\AngularProject\Polerace\src\app\Platform\orders\services\order.service.ts", "TypeScript", 25, 0, 0, 0, 10, 35
"d:\AngularProject\Polerace\src\app\Platform\orders\services\walmart-orders.service.ts", "TypeScript", 17, 0, 0, 0, 7, 24
"d:\AngularProject\Polerace\src\app\Platform\orders\view-order\view-order.component.html", "HTML", 0, 92, 0, 2, 9, 103
"d:\AngularProject\Polerace\src\app\Platform\orders\view-order\view-order.component.scss", "SCSS", 0, 0, 16, 0, 5, 21
"d:\AngularProject\Polerace\src\app\Platform\orders\view-order\view-order.component.spec.ts", "TypeScript", 20, 0, 0, 0, 6, 26
"d:\AngularProject\Polerace\src\app\Platform\orders\view-order\view-order.component.ts", "TypeScript", 41, 0, 0, 0, 8, 49
"d:\AngularProject\Polerace\src\app\Platform\reports\components\market-places-profit-list\market-places-profit-list.component.html", "HTML", 0, 173, 0, 46, 15, 234
"d:\AngularProject\Polerace\src\app\Platform\reports\components\market-places-profit-list\market-places-profit-list.component.scss", "SCSS", 0, 0, 65, 2, 11, 78
"d:\AngularProject\Polerace\src\app\Platform\reports\components\market-places-profit-list\market-places-profit-list.component.spec.ts", "TypeScript", 20, 0, 0, 0, 6, 26
"d:\AngularProject\Polerace\src\app\Platform\reports\components\market-places-profit-list\market-places-profit-list.component.ts", "TypeScript", 331, 0, 0, 0, 24, 355
"d:\AngularProject\Polerace\src\app\Platform\reports\components\profit-list\profit-list.component.html", "HTML", 0, 157, 0, 40, 17, 214
"d:\AngularProject\Polerace\src\app\Platform\reports\components\profit-list\profit-list.component.scss", "SCSS", 0, 0, 93, 5, 14, 112
"d:\AngularProject\Polerace\src\app\Platform\reports\components\profit-list\profit-list.component.spec.ts", "TypeScript", 20, 0, 0, 0, 6, 26
"d:\AngularProject\Polerace\src\app\Platform\reports\components\profit-list\profit-list.component.ts", "TypeScript", 291, 0, 0, 2, 23, 316
"d:\AngularProject\Polerace\src\app\Platform\reports\reports-routing.module.ts", "TypeScript", 19, 0, 0, 0, 3, 22
"d:\AngularProject\Polerace\src\app\Platform\reports\reports.module.ts", "TypeScript", 30, 0, 0, 0, 2, 32
"d:\AngularProject\Polerace\src\app\Platform\reports\services\reports.service.spec.ts", "TypeScript", 12, 0, 0, 0, 5, 17
"d:\AngularProject\Polerace\src\app\Platform\reports\services\reports.service.ts", "TypeScript", 21, 0, 0, 0, 4, 25
"d:\AngularProject\Polerace\src\app\Platform\sellers\components\add-seller\add-seller.component.html", "HTML", 0, 294, 0, 0, 4, 298
"d:\AngularProject\Polerace\src\app\Platform\sellers\components\add-seller\add-seller.component.scss", "SCSS", 0, 0, 54, 2, 14, 70
"d:\AngularProject\Polerace\src\app\Platform\sellers\components\add-seller\add-seller.component.ts", "TypeScript", 205, 0, 0, 10, 15, 230
"d:\AngularProject\Polerace\src\app\Platform\sellers\components\manage-sellers\manage-sellers.component.html", "HTML", 0, 108, 0, 9, 5, 122
"d:\AngularProject\Polerace\src\app\Platform\sellers\components\manage-sellers\manage-sellers.component.scss", "SCSS", 0, 0, 160, 6, 38, 204
"d:\AngularProject\Polerace\src\app\Platform\sellers\components\manage-sellers\manage-sellers.component.ts", "TypeScript", 178, 0, 0, 0, 22, 200
"d:\AngularProject\Polerace\src\app\Platform\sellers\sellers-routing.module.ts", "TypeScript", 22, 0, 0, 0, 4, 26
"d:\AngularProject\Polerace\src\app\Platform\sellers\sellers.module.ts", "TypeScript", 112, 0, 0, 0, 1, 113
"d:\AngularProject\Polerace\src\app\Platform\sellers\services\sellers.service.ts", "TypeScript", 58, 0, 0, 2, 8, 68
"d:\AngularProject\Polerace\src\app\Platform\setting\components\changepassword\changepassword.component.html", "HTML", 0, 1, 0, 0, 1, 2
"d:\AngularProject\Polerace\src\app\Platform\setting\components\changepassword\changepassword.component.scss", "SCSS", 0, 0, 0, 0, 1, 1
"d:\AngularProject\Polerace\src\app\Platform\setting\components\changepassword\changepassword.component.spec.ts", "TypeScript", 20, 0, 0, 0, 6, 26
"d:\AngularProject\Polerace\src\app\Platform\setting\components\changepassword\changepassword.component.ts", "TypeScript", 11, 0, 0, 0, 5, 16
"d:\AngularProject\Polerace\src\app\Platform\settings\components\add-users\add-users.component.html", "HTML", 0, 257, 0, 0, 46, 303
"d:\AngularProject\Polerace\src\app\Platform\settings\components\add-users\add-users.component.scss", "SCSS", 0, 0, 11, 1, 5, 17
"d:\AngularProject\Polerace\src\app\Platform\settings\components\add-users\add-users.component.spec.ts", "TypeScript", 20, 0, 0, 0, 6, 26
"d:\AngularProject\Polerace\src\app\Platform\settings\components\add-users\add-users.component.ts", "TypeScript", 175, 0, 0, 16, 25, 216
"d:\AngularProject\Polerace\src\app\Platform\settings\components\changepassword\changepassword.component.html", "HTML", 0, 38, 0, 0, 0, 38
"d:\AngularProject\Polerace\src\app\Platform\settings\components\changepassword\changepassword.component.scss", "SCSS", 0, 0, 7, 0, 2, 9
"d:\AngularProject\Polerace\src\app\Platform\settings\components\changepassword\changepassword.component.spec.ts", "TypeScript", 20, 0, 0, 0, 6, 26
"d:\AngularProject\Polerace\src\app\Platform\settings\components\changepassword\changepassword.component.ts", "TypeScript", 46, 0, 0, 0, 10, 56
"d:\AngularProject\Polerace\src\app\Platform\settings\components\company-profile\company-profile.component.html", "HTML", 0, 0, 0, 278, 4, 282
"d:\AngularProject\Polerace\src\app\Platform\settings\components\company-profile\company-profile.component.scss", "SCSS", 0, 0, 10, 1, 1, 12
"d:\AngularProject\Polerace\src\app\Platform\settings\components\company-profile\company-profile.component.spec.ts", "TypeScript", 20, 0, 0, 0, 6, 26
"d:\AngularProject\Polerace\src\app\Platform\settings\components\company-profile\company-profile.component.ts", "TypeScript", 131, 0, 0, 6, 11, 148
"d:\AngularProject\Polerace\src\app\Platform\settings\components\footer\footer.component.html", "HTML", 0, 71, 0, 7, 1, 79
"d:\AngularProject\Polerace\src\app\Platform\settings\components\footer\footer.component.scss", "SCSS", 0, 0, 0, 0, 1, 1
"d:\AngularProject\Polerace\src\app\Platform\settings\components\footer\footer.component.spec.ts", "TypeScript", 20, 0, 0, 0, 6, 26
"d:\AngularProject\Polerace\src\app\Platform\settings\components\footer\footer.component.ts", "TypeScript", 11, 0, 0, 0, 5, 16
"d:\AngularProject\Polerace\src\app\Platform\settings\components\header\header.component.html", "HTML", 0, 16, 0, 5, 3, 24
"d:\AngularProject\Polerace\src\app\Platform\settings\components\header\header.component.scss", "SCSS", 0, 0, 0, 0, 1, 1
"d:\AngularProject\Polerace\src\app\Platform\settings\components\header\header.component.spec.ts", "TypeScript", 20, 0, 0, 0, 6, 26
"d:\AngularProject\Polerace\src\app\Platform\settings\components\header\header.component.ts", "TypeScript", 11, 0, 0, 0, 5, 16
"d:\AngularProject\Polerace\src\app\Platform\settings\components\manage-groups\manage-groups.component.html", "HTML", 0, 243, 0, 0, 55, 298
"d:\AngularProject\Polerace\src\app\Platform\settings\components\manage-groups\manage-groups.component.scss", "SCSS", 0, 0, 34, 1, 1, 36
"d:\AngularProject\Polerace\src\app\Platform\settings\components\manage-groups\manage-groups.component.ts", "TypeScript", 339, 0, 0, 12, 20, 371
"d:\AngularProject\Polerace\src\app\Platform\settings\components\manage-users\manage-users.component.html", "HTML", 0, 161, 0, 8, 8, 177
"d:\AngularProject\Polerace\src\app\Platform\settings\components\manage-users\manage-users.component.scss", "SCSS", 0, 0, 13, 0, 2, 15
"d:\AngularProject\Polerace\src\app\Platform\settings\components\manage-users\manage-users.component.spec.ts", "TypeScript", 20, 0, 0, 0, 6, 26
"d:\AngularProject\Polerace\src\app\Platform\settings\components\manage-users\manage-users.component.ts", "TypeScript", 89, 0, 0, 5, 8, 102
"d:\AngularProject\Polerace\src\app\Platform\settings\components\my-profile\my-profile.component.html", "HTML", 0, 322, 0, 0, 58, 380
"d:\AngularProject\Polerace\src\app\Platform\settings\components\my-profile\my-profile.component.scss", "SCSS", 0, 0, 17, 1, 0, 18
"d:\AngularProject\Polerace\src\app\Platform\settings\components\my-profile\my-profile.component.spec.ts", "TypeScript", 20, 0, 0, 0, 6, 26
"d:\AngularProject\Polerace\src\app\Platform\settings\components\my-profile\my-profile.component.ts", "TypeScript", 237, 0, 0, 13, 28, 278
"d:\AngularProject\Polerace\src\app\Platform\settings\components\stripe-payment\stripe-payment.component.html", "HTML", 0, 12, 0, 0, 2, 14
"d:\AngularProject\Polerace\src\app\Platform\settings\components\stripe-payment\stripe-payment.component.scss", "SCSS", 0, 0, 18, 0, 6, 24
"d:\AngularProject\Polerace\src\app\Platform\settings\components\stripe-payment\stripe-payment.component.spec.ts", "TypeScript", 20, 0, 0, 0, 6, 26
"d:\AngularProject\Polerace\src\app\Platform\settings\components\stripe-payment\stripe-payment.component.ts", "TypeScript", 98, 0, 0, 2, 12, 112
"d:\AngularProject\Polerace\src\app\Platform\settings\components\update-subscription\update-subscription.component.html", "HTML", 0, 89, 0, 1, 4, 94
"d:\AngularProject\Polerace\src\app\Platform\settings\components\update-subscription\update-subscription.component.scss", "SCSS", 0, 0, 62, 2, 11, 75
"d:\AngularProject\Polerace\src\app\Platform\settings\components\update-subscription\update-subscription.component.spec.ts", "TypeScript", 20, 0, 0, 0, 6, 26
"d:\AngularProject\Polerace\src\app\Platform\settings\components\update-subscription\update-subscription.component.ts", "TypeScript", 171, 0, 0, 0, 11, 182
"d:\AngularProject\Polerace\src\app\Platform\settings\components\updateprofile\updateprofile.component.html", "HTML", 0, 295, 0, 2, 9, 306
"d:\AngularProject\Polerace\src\app\Platform\settings\components\updateprofile\updateprofile.component.scss", "SCSS", 0, 0, 75, 2, 7, 84
"d:\AngularProject\Polerace\src\app\Platform\settings\components\updateprofile\updateprofile.component.spec.ts", "TypeScript", 20, 0, 0, 0, 6, 26
"d:\AngularProject\Polerace\src\app\Platform\settings\components\updateprofile\updateprofile.component.ts", "TypeScript", 251, 0, 0, 10, 19, 280
"d:\AngularProject\Polerace\src\app\Platform\settings\services\common.service.ts", "TypeScript", 26, 0, 0, 2, 8, 36
"d:\AngularProject\Polerace\src\app\Platform\settings\services\users.service.ts", "TypeScript", 119, 0, 0, 25, 29, 173
"d:\AngularProject\Polerace\src\app\Platform\settings\settings-routing.module.ts", "TypeScript", 64, 0, 0, 0, 3, 67
"d:\AngularProject\Polerace\src\app\Platform\settings\settings.module.ts", "TypeScript", 116, 0, 0, 0, 2, 118
"d:\AngularProject\Polerace\src\app\Platform\shipping-package\component\create-shipping-package\create-shipping-package.component.html", "HTML", 0, 262, 0, 0, 17, 279
"d:\AngularProject\Polerace\src\app\Platform\shipping-package\component\create-shipping-package\create-shipping-package.component.scss", "SCSS", 0, 0, 48, 1, 6, 55
"d:\AngularProject\Polerace\src\app\Platform\shipping-package\component\create-shipping-package\create-shipping-package.component.spec.ts", "TypeScript", 20, 0, 0, 0, 6, 26
"d:\AngularProject\Polerace\src\app\Platform\shipping-package\component\create-shipping-package\create-shipping-package.component.ts", "TypeScript", 183, 0, 0, 0, 16, 199
"d:\AngularProject\Polerace\src\app\Platform\shipping-package\component\manage-shipping-package\manage-shipping-package.component.html", "HTML", 0, 102, 0, 7, 7, 116
"d:\AngularProject\Polerace\src\app\Platform\shipping-package\component\manage-shipping-package\manage-shipping-package.component.scss", "SCSS", 0, 0, 110, 3, 20, 133
"d:\AngularProject\Polerace\src\app\Platform\shipping-package\component\manage-shipping-package\manage-shipping-package.component.spec.ts", "TypeScript", 20, 0, 0, 0, 6, 26
"d:\AngularProject\Polerace\src\app\Platform\shipping-package\component\manage-shipping-package\manage-shipping-package.component.ts", "TypeScript", 208, 0, 0, 0, 16, 224
"d:\AngularProject\Polerace\src\app\Platform\shipping-package\service\shipping-package.service.spec.ts", "TypeScript", 12, 0, 0, 0, 5, 17
"d:\AngularProject\Polerace\src\app\Platform\shipping-package\service\shipping-package.service.ts", "TypeScript", 26, 0, 0, 0, 7, 33
"d:\AngularProject\Polerace\src\app\Platform\shipping-package\shipping-package-routing.module.ts", "TypeScript", 23, 0, 0, 0, 4, 27
"d:\AngularProject\Polerace\src\app\Platform\shipping-package\shipping-package.module.ts", "TypeScript", 112, 0, 0, 0, 1, 113
"d:\AngularProject\Polerace\src\app\Platform\subscription\components\add-subscription-plan\add-subscription-plan.component.html", "HTML", 0, 82, 0, 1, 4, 87
"d:\AngularProject\Polerace\src\app\Platform\subscription\components\add-subscription-plan\add-subscription-plan.component.scss", "SCSS", 0, 0, 54, 2, 14, 70
"d:\AngularProject\Polerace\src\app\Platform\subscription\components\add-subscription-plan\add-subscription-plan.component.spec.ts", "TypeScript", 20, 0, 0, 0, 6, 26
"d:\AngularProject\Polerace\src\app\Platform\subscription\components\add-subscription-plan\add-subscription-plan.component.ts", "TypeScript", 123, 0, 0, 2, 12, 137
"d:\AngularProject\Polerace\src\app\Platform\subscription\components\subscription-listing\subscription-listing.component.html", "HTML", 0, 113, 0, 7, 5, 125
"d:\AngularProject\Polerace\src\app\Platform\subscription\components\subscription-listing\subscription-listing.component.scss", "SCSS", 0, 0, 160, 6, 38, 204
"d:\AngularProject\Polerace\src\app\Platform\subscription\components\subscription-listing\subscription-listing.component.spec.ts", "TypeScript", 20, 0, 0, 0, 6, 26
"d:\AngularProject\Polerace\src\app\Platform\subscription\components\subscription-listing\subscription-listing.component.ts", "TypeScript", 144, 0, 0, 1, 16, 161
"d:\AngularProject\Polerace\src\app\Platform\subscription\services\subscription-service.service.spec.ts", "TypeScript", 12, 0, 0, 0, 5, 17
"d:\AngularProject\Polerace\src\app\Platform\subscription\services\subscription-service.service.ts", "TypeScript", 25, 0, 0, 7, 11, 43
"d:\AngularProject\Polerace\src\app\Platform\subscription\subscription-routing.module.ts", "TypeScript", 18, 0, 0, 0, 4, 22
"d:\AngularProject\Polerace\src\app\Platform\subscription\subscription.module.ts", "TypeScript", 28, 0, 0, 0, 2, 30
"d:\AngularProject\Polerace\src\app\app-routing.module.ts", "TypeScript", 39, 0, 0, 10, 6, 55
"d:\AngularProject\Polerace\src\app\app.component.html", "HTML", 0, 1, 0, 0, 2, 3
"d:\AngularProject\Polerace\src\app\app.component.scss", "SCSS", 0, 0, 0, 0, 1, 1
"d:\AngularProject\Polerace\src\app\app.component.spec.ts", "TypeScript", 27, 0, 0, 0, 5, 32
"d:\AngularProject\Polerace\src\app\app.component.ts", "TypeScript", 24, 0, 0, 7, 9, 40
"d:\AngularProject\Polerace\src\app\app.module.ts", "TypeScript", 90, 0, 0, 4, 3, 97
"d:\AngularProject\Polerace\src\app\auth\auth-gaurd.ts", "TypeScript", 18, 0, 0, 3, 6, 27
"d:\AngularProject\Polerace\src\app\auth\auth-routing.module.ts", "TypeScript", 14, 0, 0, 0, 3, 17
"d:\AngularProject\Polerace\src\app\auth\auth.module.ts", "TypeScript", 28, 0, 0, 2, 7, 37
"d:\AngularProject\Polerace\src\app\auth\login\components\authfooter\authfooter.component.html", "HTML", 0, 1, 0, 1, 2, 4
"d:\AngularProject\Polerace\src\app\auth\login\components\authfooter\authfooter.component.scss", "SCSS", 0, 0, 5, 0, 1, 6
"d:\AngularProject\Polerace\src\app\auth\login\components\authfooter\authfooter.component.spec.ts", "TypeScript", 20, 0, 0, 0, 6, 26
"d:\AngularProject\Polerace\src\app\auth\login\components\authfooter\authfooter.component.ts", "TypeScript", 14, 0, 0, 4, 5, 23
"d:\AngularProject\Polerace\src\app\auth\login\components\authheader\authheader.component.html", "HTML", 0, 11, 0, 0, 3, 14
"d:\AngularProject\Polerace\src\app\auth\login\components\authheader\authheader.component.scss", "SCSS", 0, 0, 3, 0, 1, 4
"d:\AngularProject\Polerace\src\app\auth\login\components\authheader\authheader.component.spec.ts", "TypeScript", 20, 0, 0, 0, 6, 26
"d:\AngularProject\Polerace\src\app\auth\login\components\authheader\authheader.component.ts", "TypeScript", 12, 0, 0, 0, 6, 18
"d:\AngularProject\Polerace\src\app\auth\login\components\login.component.html", "HTML", 0, 46, 0, 15, 7, 68
"d:\AngularProject\Polerace\src\app\auth\login\components\login.component.scss", "SCSS", 0, 0, 44, 2, 9, 55
"d:\AngularProject\Polerace\src\app\auth\login\components\login.component.spec.ts", "TypeScript", 20, 0, 0, 0, 6, 26
"d:\AngularProject\Polerace\src\app\auth\login\components\login.component.ts", "TypeScript", 98, 0, 0, 3, 6, 107
"d:\AngularProject\Polerace\src\app\auth\login\components\register\register.component.html", "HTML", 0, 99, 0, 6, 12, 117
"d:\AngularProject\Polerace\src\app\auth\login\components\register\register.component.scss", "SCSS", 0, 0, 44, 5, 11, 60
"d:\AngularProject\Polerace\src\app\auth\login\components\register\register.component.spec.ts", "TypeScript", 20, 0, 0, 0, 6, 26
"d:\AngularProject\Polerace\src\app\auth\login\components\register\register.component.ts", "TypeScript", 54, 0, 0, 0, 5, 59
"d:\AngularProject\Polerace\src\app\auth\login\components\resetpassword\resetpassword.component.html", "HTML", 0, 47, 0, 79, 8, 134
"d:\AngularProject\Polerace\src\app\auth\login\components\resetpassword\resetpassword.component.scss", "SCSS", 0, 0, 16, 0, 5, 21
"d:\AngularProject\Polerace\src\app\auth\login\components\resetpassword\resetpassword.component.spec.ts", "TypeScript", 20, 0, 0, 0, 6, 26
"d:\AngularProject\Polerace\src\app\auth\login\components\resetpassword\resetpassword.component.ts", "TypeScript", 26, 0, 0, 2, 12, 40
"d:\AngularProject\Polerace\src\app\auth\login\components\retrivepassword\retrivepassword.component.html", "HTML", 0, 37, 0, 3, 13, 53
"d:\AngularProject\Polerace\src\app\auth\login\components\retrivepassword\retrivepassword.component.scss", "SCSS", 0, 0, 7, 0, 2, 9
"d:\AngularProject\Polerace\src\app\auth\login\components\retrivepassword\retrivepassword.component.spec.ts", "TypeScript", 20, 0, 0, 0, 6, 26
"d:\AngularProject\Polerace\src\app\auth\login\components\retrivepassword\retrivepassword.component.ts", "TypeScript", 26, 0, 0, 1, 8, 35
"d:\AngularProject\Polerace\src\app\auth\login\login-routing.module.ts", "TypeScript", 29, 0, 0, 0, 3, 32
"d:\AngularProject\Polerace\src\app\auth\login\login.module.ts", "TypeScript", 36, 0, 0, 2, 2, 40
"d:\AngularProject\Polerace\src\app\auth\models\forgotPassword.ts", "TypeScript", 3, 0, 0, 0, 1, 4
"d:\AngularProject\Polerace\src\app\auth\models\register.ts", "TypeScript", 8, 0, 0, 0, 1, 9
"d:\AngularProject\Polerace\src\app\auth\models\resetPassword.ts", "TypeScript", 8, 0, 0, 0, 2, 10
"d:\AngularProject\Polerace\src\app\auth\service\auth.service.spec.ts", "TypeScript", 9, 0, 0, 0, 4, 13
"d:\AngularProject\Polerace\src\app\auth\service\auth.service.ts", "TypeScript", 53, 0, 0, 0, 9, 62
"d:\AngularProject\Polerace\src\app\auth\service\multi-translate-loader.ts", "TypeScript", 22, 0, 0, 6, 4, 32
"d:\AngularProject\Polerace\src\app\common-service.service.spec.ts", "TypeScript", 12, 0, 0, 0, 5, 17
"d:\AngularProject\Polerace\src\app\common-service.service.ts", "TypeScript", 16, 0, 0, 0, 3, 19
"d:\AngularProject\Polerace\src\app\home\components\solutions\solutions.component.html", "HTML", 0, 1, 0, 0, 1, 2
"d:\AngularProject\Polerace\src\app\home\components\solutions\solutions.component.scss", "SCSS", 0, 0, 0, 0, 1, 1
"d:\AngularProject\Polerace\src\app\home\components\solutions\solutions.component.spec.ts", "TypeScript", 20, 0, 0, 0, 6, 26
"d:\AngularProject\Polerace\src\app\home\components\solutions\solutions.component.ts", "TypeScript", 11, 0, 0, 0, 5, 16
"d:\AngularProject\Polerace\src\app\shared\MustMatch.ts", "TypeScript", 15, 0, 0, 3, 4, 22
"d:\AngularProject\Polerace\src\app\shared\confirm-dialog\confirm-dialog.component.html", "HTML", 0, 7, 0, 24, 2, 33
"d:\AngularProject\Polerace\src\app\shared\confirm-dialog\confirm-dialog.component.scss", "SCSS", 0, 0, 2, 0, 1, 3
"d:\AngularProject\Polerace\src\app\shared\confirm-dialog\confirm-dialog.component.spec.ts", "TypeScript", 20, 0, 0, 0, 6, 26
"d:\AngularProject\Polerace\src\app\shared\confirm-dialog\confirm-dialog.component.ts", "TypeScript", 16, 0, 0, 0, 6, 22
"d:\AngularProject\Polerace\src\app\shared\confirmation-dialog\confirmation-dialog.component.html", "HTML", 0, 9, 0, 0, 3, 12
"d:\AngularProject\Polerace\src\app\shared\confirmation-dialog\confirmation-dialog.component.scss", "SCSS", 0, 0, 2, 0, 1, 3
"d:\AngularProject\Polerace\src\app\shared\confirmation-dialog\confirmation-dialog.component.ts", "TypeScript", 29, 0, 0, 0, 6, 35
"d:\AngularProject\Polerace\src\app\shared\directives\number-only.directive.ts", "TypeScript", 14, 0, 0, 0, 6, 20
"d:\AngularProject\Polerace\src\app\shared\directives\phone-masking.directive.ts", "TypeScript", 35, 0, 0, 0, 7, 42
"d:\AngularProject\Polerace\src\app\shared\enums\channels.ts", "TypeScript", 5, 0, 0, 0, 1, 6
"d:\AngularProject\Polerace\src\app\shared\helpers\permissions-helper.ts", "TypeScript", 72, 0, 0, 0, 12, 84
"d:\AngularProject\Polerace\src\app\shared\language-selector\language-selector.component.html", "HTML", 0, 14, 0, 0, 1, 15
"d:\AngularProject\Polerace\src\app\shared\language-selector\language-selector.component.scss", "SCSS", 0, 0, 0, 0, 1, 1
"d:\AngularProject\Polerace\src\app\shared\language-selector\language-selector.component.ts", "TypeScript", 33, 0, 0, 0, 7, 40
"d:\AngularProject\Polerace\src\app\shared\layout\footer\footer.component.html", "HTML", 0, 0, 0, 0, 1, 1
"d:\AngularProject\Polerace\src\app\shared\layout\footer\footer.component.scss", "SCSS", 0, 0, 0, 0, 1, 1
"d:\AngularProject\Polerace\src\app\shared\layout\footer\footer.component.ts", "TypeScript", 16, 0, 0, 0, 6, 22
"d:\AngularProject\Polerace\src\app\shared\layout\header\header.component.html", "HTML", 0, 0, 0, 0, 1, 1
"d:\AngularProject\Polerace\src\app\shared\layout\header\header.component.scss", "SCSS", 0, 0, 35, 2, 3, 40
"d:\AngularProject\Polerace\src\app\shared\layout\header\header.component.ts", "TypeScript", 105, 0, 0, 4, 10, 119
"d:\AngularProject\Polerace\src\app\shared\layout\main\main.component.html", "HTML", 0, 721, 0, 52, 46, 819
"d:\AngularProject\Polerace\src\app\shared\layout\main\main.component.scss", "SCSS", 0, 0, 6, 0, 2, 8
"d:\AngularProject\Polerace\src\app\shared\layout\main\main.component.ts", "TypeScript", 98, 0, 0, 3, 21, 122
"d:\AngularProject\Polerace\src\app\shared\layout\sidebar\sidebar.component.html", "HTML", 0, 0, 0, 0, 1, 1
"d:\AngularProject\Polerace\src\app\shared\layout\sidebar\sidebar.component.scss", "SCSS", 0, 0, 12, 0, 0, 12
"d:\AngularProject\Polerace\src\app\shared\layout\sidebar\sidebar.component.spec.ts", "TypeScript", 20, 0, 0, 0, 6, 26
"d:\AngularProject\Polerace\src\app\shared\layout\sidebar\sidebar.component.ts", "TypeScript", 11, 0, 0, 0, 5, 16
"d:\AngularProject\Polerace\src\app\shared\models\common.ts", "TypeScript", 21, 0, 0, 0, 4, 25
"d:\AngularProject\Polerace\src\app\shared\models\language.ts", "TypeScript", 8, 0, 0, 0, 1, 9
"d:\AngularProject\Polerace\src\app\shared\models\languages.ts", "TypeScript", 20, 0, 0, 0, 3, 23
"d:\AngularProject\Polerace\src\app\shared\overlay\overlay.module.ts", "TypeScript", 12, 0, 0, 0, 2, 14
"d:\AngularProject\Polerace\src\app\shared\overlay\overlay.service.ts", "TypeScript", 25, 0, 0, 0, 3, 28
"d:\AngularProject\Polerace\src\app\shared\progress-spinner\progress-spinner\progress-spinner.component.html", "HTML", 0, 4, 0, 0, 1, 5
"d:\AngularProject\Polerace\src\app\shared\progress-spinner\progress-spinner\progress-spinner.component.scss", "SCSS", 0, 0, 0, 0, 1, 1
"d:\AngularProject\Polerace\src\app\shared\progress-spinner\progress-spinner\progress-spinner.component.ts", "TypeScript", 41, 0, 0, 3, 6, 50
"d:\AngularProject\Polerace\src\app\shared\progress-spinner\progress-spinner\progress-spinner.module.ts", "TypeScript", 14, 0, 0, 0, 2, 16
"d:\AngularProject\Polerace\src\app\shared\services\common.service.ts", "TypeScript", 19, 0, 0, 2, 5, 26
"d:\AngularProject\Polerace\src\app\shared\services\language.service.ts", "TypeScript", 82, 0, 0, 0, 21, 103
"d:\AngularProject\Polerace\src\app\shared\sort.pipe.ts", "TypeScript", 10, 0, 0, 10, 8, 28
"Total", "-", 17998, 15833, 5325, 2208, 4823, 46187